19,20
XXXXXXXXXXXXXXXXXXX
X........X........X
X.XX.XXX.X.XXX.XX.X
X.................X
X.XX.X.XXXXX.X.XX.X
X....X...X...X....X
XXXX.XXX.X.XXX.XXXX
XXXX.X.......X.XXXX
XXXX.X.XX_XX.X.XXXX
...X...X   X...X...
XX.....X   X.....XX
XXXX.X.XXXXX.X.XXXX
XXXX.X.......X.XXXX
XXXX.XXX.X.XXX.XXXX
X....X...X...X....X
X.XX.X.XXXXX.X.XX.X
X.................X
X.XX.XXX.X.XXX.XX.X
X...C....X........X
XXXXXXXXXXXXXXXXXXX